2 2 2 2 2 2 2 0 0 0 0 0 0 0 0 0 0 0 0 0 0 0 0 0 0 
2 1 1 2 2 2 2 2 2 2 2 0 0 0 0 0 2 2 2 2 0 0 0 0 0 
2 1 1 1 2 2 2 1 1 1 2 0 0 0 0 0 2 1 1 2 0 0 0 0 0 
2 2 1 1 1 2 2 1 1 1 2 2 2 2 2 2 2 1 1 2 0 0 0 0 0 
2 2 1 1 1 1 1 1 1 1 1 1 1 1 1 2 2 1 2 2 0 0 0 0 0 
2 2 1 1 1 1 2 1 2 2 2 2 2 2 1 2 2 1 2 0 0 0 0 0 0 
2 2 1 1 2 2 2 1 1 1 1 1 1 2 1 2 2 1 2 0 0 0 0 0 0 
0 2 1 1 2 2 2 2 2 2 1 1 1 2 1 1 1 1 2 0 0 0 0 0 0 
0 2 1 1 2 2 1 1 1 2 1 1 1 2 1 2 2 2 2 0 0 0 0 0 0 
2 2 1 1 2 2 1 1 1 2 2 1 2 2 1 2 0 0 0 0 0 0 0 0 0 
2 2 2 1 2 1 1 1 1 1 1 1 1 1 1 2 0 0 0 0 0 0 0 0 0 
2 1 1 1 2 2 2 2 1 2 2 1 2 2 2 2 0 0 0 0 0 0 0 0 0 
2 1 1 1 1 1 1 1 1 2 1 1 2 0 0 0 0 0 0 0 0 0 0 0 0 
2 2 2 1 1 1 1 1 1 1 1 1 2 2 2 2 2 2 2 2 0 0 0 0 0 
2 2 2 2 2 2 2 1 1 1 1 1 1 1 1 1 1 1 1 2 0 0 0 0 0 
0 0 0 0 0 0 2 1 1 1 1 1 2 2 2 2 2 2 2 2 0 0 0 0 0 
0 0 0 0 0 0 2 1 2 2 2 2 2 2 0 0 0 0 0 0 0 0 0 0 0 
0 0 0 0 0 0 2 1 1 1 1 1 1 2 0 0 0 0 0 0 0 0 0 0 0 
0 0 0 0 0 0 2 3 1 1 1 1 1 2 0 0 0 0 0 0 0 0 0 0 0 
0 0 0 0 0 0 2 1 1 1 1 1 1 2 0 0 0 0 0 0 0 0 0 0 0 
0 0 0 0 0 0 2 2 2 2 2 2 2 2 0 0 0 0 0 0 0 0 0 0 0 
0 0 0 0 0 0 0 0 0 0 0 0 0 0 0 0 0 0 0 0 0 0 0 0 0 
0 0 0 0 0 0 0 0 0 0 0 0 0 0 0 0 0 0 0 0 0 0 0 0 0 
0 0 0 0 0 0 0 0 0 0 0 0 0 0 0 0 0 0 0 0 0 0 0 0 0 
0 0 0 0 0 0 0 0 0 0 0 0 0 0 0 0 0 0 0 0 0 0 0 0 0 
0 0 0 0 0 0 0 0 0 0 0 0 0 0 0 0 0 0 0 0 0 0 0 0 0 
0 0 0 0 0 0 0 0 0 0 0 0 0 0 0 0 0 0 0 0 0 0 0 0 0 
0 0 0 0 0 0 0 0 0 0 0 0 0 0 0 0 0 0 0 0 0 0 0 0 0 
0 0 0 0 0 0 0 0 0 0 0 0 0 0 0 0 0 0 0 0 0 0 0 0 0 
0 0 0 0 0 0 0 0 0 0 0 0 0 0 0 0 0 0 0 0 0 0 0 0 0 
0 0 0 0 0 0 0 0 0 0 0 0 0 0 0 0 0 0 0 0 0 0 0 0 0 
0 0 0 0 0 0 0 0 0 0 0 0 0 0 0 0 0 0 0 0 0 0 0 0 0 
0 0 0 0 0 0 0 0 0 0 0 0 0 0 0 0 0 0 0 0 0 0 0 0 0 
0 0 0 0 0 0 0 0 0 0 0 0 0 0 0 0 0 0 0 0 0 0 0 0 0 
0 0 0 0 0 0 0 0 0 0 0 0 0 0 0 0 0 0 0 0 0 0 0 0 0 
0 0 0 0 0 0 0 0 0 0 0 0 0 0 0 0 0 0 0 0 0 0 0 0 0 
0 0 0 0 0 0 0 0 0 0 0 0 0 0 0 0 0 0 0 0 0 0 0 0 0 
0 0 0 0 0 0 0 0 0 0 0 0 0 0 0 0 0 0 0 0 0 0 0 0 0 
0 0 0 0 0 0 0 0 0 0 0 0 0 0 0 0 0 0 0 0 0 0 0 0 0 
0 0 0 0 0 0 0 0 0 0 0 0 0 0 0 0 0 0 0 0 0 0 0 0 0 
-
0 --SpriteID
Fat Man=--Sprite Name
7/5/--spriteXY
test1 --eventName
0 --SpriteID
Shady Man=--Sprite Name
4/5/--spriteXY
gifting --eventName
0 --SpriteID
new guy=--Sprite Name
6/18/--spriteXY
testEvent --eventName
0 --SpriteID
Skinny Man=--Sprite Name
19/9/--spriteXY
moveEvent --eventName
