0 0 0 0 0 0 0 0 0 0 0 0 0 0 0 0 0 0 0 0 0 0 0 0 0 
0 2 2 2 2 2 0 0 0 0 0 0 0 0 0 0 0 0 0 0 0 0 0 0 0 
0 2 1 1 1 2 0 0 0 0 0 0 0 0 2 2 2 0 0 0 0 0 0 0 0 
0 2 1 3/w/maxSize3.txt/12/12 1 2 2 0 0 0 0 0 2 2 2 1 2 0 0 0 0 0 0 0 0 
0 2 1 1 1 1 2 2 2 0 0 0 2 1 1 1 2 0 0 0 0 0 0 0 0 
0 2 2 2 1 1 1 1 2 2 2 2 2 1 1 1 2 0 0 0 0 0 0 0 0 
0 0 0 2 2 1 1 1 1 1 1 1 1 1 1 1 2 0 0 0 0 0 0 0 0 
0 0 0 0 2 1 1 1 2 2 1 2 2 1 1 1 2 0 0 0 0 0 0 0 0 
0 0 0 0 2 2 1 2 2 2 1 2 2 1 1 1 2 0 0 0 0 0 0 0 0 
0 0 0 2 2 2 1 2 2 2 1 2 2 2 2 2 2 0 0 0 0 0 0 0 0 
0 0 0 2 1 1 1 1 1 2 3 2 0 0 0 0 0 0 0 0 0 0 0 0 0 
0 0 0 2 1 1 1 1 1 2 2 2 0 0 0 0 0 0 0 0 0 0 0 0 0 
0 0 0 2 1 1 1 1 1 2 0 0 0 0 0 0 0 0 0 0 0 0 0 0 0 
0 0 0 2 2 2 1 2 2 2 0 0 0 0 0 0 0 0 0 0 0 0 0 0 0 
0 0 0 0 2 1 1 1 2 0 0 0 0 0 0 0 0 0 0 0 0 0 0 0 0 
0 0 0 0 2 1 3/w/maxSize2.txt/6/6 1 2 0 0 0 0 0 0 0 0 0 0 0 0 0 0 0 0 
0 0 0 0 2 1 1 1 2 0 0 0 0 0 0 0 0 0 0 0 0 0 0 0 0 
0 0 0 0 2 1 1 1 2 0 0 0 0 0 0 0 0 0 0 0 0 0 0 0 0 
0 0 0 0 2 1 1 1 2 0 0 0 0 0 0 0 0 0 0 0 0 0 0 0 0 
0 0 0 0 2 1 1 1 2 0 0 0 0 0 0 0 0 0 0 0 0 0 0 0 0 
0 0 0 0 2 1 1 1 2 0 0 0 0 0 0 0 0 0 0 0 0 0 0 0 0 
0 0 2 2 2 1 1 1 2 0 0 0 0 0 0 0 0 0 0 0 0 0 0 0 0 
0 0 2 7 5 5 1 1 2 0 0 0 0 0 0 0 0 0 0 0 0 0 0 0 0 
0 0 2 8 5 4/w/house1.txt/5/11 1 1 2 0 0 0 0 0 0 0 0 0 0 0 0 0 0 0 0 
0 0 2 8 5 5 1 1 2 0 0 0 0 0 0 0 0 0 0 0 0 0 0 0 0 
0 0 2 8 6 5 1 1 2 0 0 0 0 0 0 0 0 0 0 0 0 0 0 0 0 
0 0 2 9 5 5 1 1 2 0 0 0 0 0 0 0 0 0 0 0 0 0 0 0 0 
0 0 2 2 2 1 1 1 2 0 0 0 0 0 0 0 0 0 0 0 0 0 0 0 0 
0 0 0 0 2 2 2 2 2 0 0 0 0 0 0 0 0 0 0 0 0 0 0 0 0 
0 0 0 0 0 0 0 0 0 0 0 0 0 0 0 0 0 0 0 0 0 0 0 0 0 
0 0 0 0 0 0 0 0 0 0 0 0 0 0 0 0 0 0 0 0 0 0 0 0 0 
0 0 0 0 0 0 0 0 0 0 0 0 0 0 0 0 0 0 0 0 0 0 0 0 0 
0 0 0 0 0 0 0 0 0 0 0 0 0 0 0 0 0 0 0 0 0 0 0 0 0 
0 0 0 0 0 0 0 0 0 0 0 0 0 0 0 0 0 0 0 0 0 0 0 0 0 
0 0 0 0 0 0 0 0 0 0 0 0 0 0 0 0 0 0 0 0 0 0 0 0 0 
0 0 0 0 0 0 0 0 0 0 0 0 0 0 0 0 0 0 0 0 0 0 0 0 0 
0 0 0 0 0 0 0 0 0 0 0 0 0 0 0 0 0 0 0 0 0 0 0 0 0 
0 0 0 0 0 0 0 0 0 0 0 0 0 0 0 0 0 0 0 0 0 0 0 0 0 
0 0 0 0 0 0 0 0 0 0 0 0 0 0 0 0 0 0 0 0 0 0 0 0 0 
0 0 0 0 0 0 0 0 0 0 0 0 0 0 0 0 0 0 0 0 0 0 0 0 0 
-
0 --SpriteID
Harold=--Sprite Name
3/4/--spriteXY
testEvent --eventName
0 --SpriteID
Skinny Man=--Sprite Name
3/4/--spriteXY
moveEvent --eventName
0 --SpriteID
Gifter Man=--Sprite Name
3/4/--spriteXY
gifting --eventName
