0 0 0 0 0 0 0 0 0 0 0 0 0 
0 0 0 0 0 0 0 0 0 0 0 0 0 
0 0 0 0 5 5 5 5 5 5 5 5 0 
0 0 0 0 5 10 10 10 10 10 10 5 0 
0 0 0 0 5 10 10 10 10 10 10 4 0 
0 0 0 0 5 10 10 10 10 10 10 5 0 
0 0 0 0 5 10 10 10 10 10 10 5 0 
0 0 0 0 5 10 10 10 10 10 10 5 0 
0 0 0 0 5 10 10 10 10 10 10 5 0 
0 0 0 0 5 10 10 10 10 10 10 5 0 
0 0 0 0 5 5 5 5 5 5 5 5 0 
0 0 0 0 0 0 0 0 0 0 0 0 0 
0 0 0 0 0 0 0 0 0 0 0 0 0 
-
